#######  0
#..***#
#..\\\#
#...**#
#.*.*\#
LR....#
#######

#######  1
#..***#
#..\\\#
#...**#
#.*.*\#
L R...#
#######

#######  2
#..***#
#..\\\#
#...**#
#. .*\#
L *R..#
#######

#######  3
#..***#
#..\\\#
#...**#
#. .*\#
L * R.#
#######

#######  4
#..***#
#..\\\#
#... *#
#. .*\#
L *R*.#
#######

#######  5
#..***#
#..\\\#
#... *#
#. R*\#
L * *.#
#######

#######  6
#..***#
#..\\\#
#... *#
#.R  \#
L ***.#
#######